я не сидел без дела|nie siedziałem bezczynnie
я стараюсь изо всех сил|staram się jak mogę
чем дальше, тем больше смысла|im dalej, tym więcej sensu
это происходит один раз в год|zdarza się to raz w roku
самые редко используемые слова|najmniej używane słowa
самые часто используемые слова|najczęściej używane słowa
пойти на уступки|robić ustępstwa
здесь мы имели дело с|tutaj mieliśmy do czynienia z
он выплатил только половину долга|spłacił dopiero połowę długu
он прошел этот путь очень быстро|przeszedł tę ścieżkę bardzo szybko
это сложнее|to jest trudniejsze
это проще|to jest łatwiejsze
кроме моей дочери|oprócz mojej córki
здесь нет ни одной женщины|nie ma tu żadnej kobiety
не хочу показаться жестоким|nie zamierzam brzmieć okrutnie
я делаю это по своему|robię to po swojemu
с которым он боролся всю свою жизнь|przeciw którege przez życie całe walczył
spaced repetition|powtarzanie w odstępach
отложить все дела|odłożyć wszystko na bok
ситуация по-прежнему сложная|sytuacja nadal jest trudna
среди доступных на рынке и типа контракта|spośród dostępnych na rynku i rodzaju umowy
как раньше уже не будет|już nie będzie tak jak kiedyś
мне кажется|coś mi się wydaje
их постоянно опровергать|na bieżąco ich obalać
иностранцы необходимы|cudzoziemcy są niezbędni
живу с мыслью, что однажды|żyję z myślą, że pewnego dnia
полностью осознают плюсы и минусы|mają pełną świadomość wad i zalet
президент намерен наложить вето|prezydent zamierza zawetować
довести до автоматизма|doprowadzić do automatyzmu
как вы думаете, что там?|co według was tam jest?
люди становятся жертвами своей судьбы|ludzie padają ofiarami swojego losu
именно об этом и шла речь|no właśnie dokładnie o to chodziło
с его точки зрения|z jego punktu widzenia
это явление становится все более распространенным|zjawisko to staje się coraz bardziej powszechne
пока не попробуешь не узнаешь|dopóki nie spróbujesz, nie będziesz wiedział
и все больше заявляют о готовности покинуть страну|a więcej zapowiada opuszczenie kraju
он живет здесь только с января|mieszka tu dopiero od stycznia
кажется, гораздо разумнее подождать|dużo bardziej rozsądnym wydaje się czekanie
второй день подряд|drugi dzień z rzędu
возможность заключения договора|możliwość zawarcia umowy
подтвердил, что восхищается им|potwierdził, że go podziwia
столкнулся с реальностью|zderzyłem się z rzeczywistością
становишся таким же самым|stajesz się taki sam
я редко помню свои сны|rzadko pamiętam swoje sny
пока что о тех, кто работает в поле|do tej pory wobec pracujących na polu
я вспомнил о тебе|pamiętałem o tobie
потому что я встретил талантливых учителей|bo trafiłem na zdolnych nauczycieli
между ними нет никакой разницы|nie ma między nimi żadnej różnicy
в отличии от других|w przeciwieństwie do innych
постараюсь не забыть|postaram się nie zapomnieć
я уже все забыл|już wszystko zapomniałem
только что вспомнил о тебе|właśnie o tobie pomyślałem
есть только одна причина|jest tylko jeden powód
он сделает еще хуже|on tylko pogorszy sprawę
оглядываясь назад, это настолько очевидно|z perspektywy czasu jest to takie oczywiste
по статистике, вероятность, что вы умрете|według statystyk szansa, że zginiesz
несмотря на огромные человеческие потери|mimo gigantycznych strat w ludziach
и самое главное|i co najważniejsze
в таких обстоятельствах|w takich okolicznościach
сделанный на основе|zrobiony na podstawie
что еще должно произойти|co jeszcze musi się stać
ни при каких обстоятельствах|pod żadnym pozorem
убеди самого себя|przekonaj się sam
огромный рост поддержки|olbrzymi wzrost poparcia
во многих отношениях оплот нормальности|w wielu kwestiach ostoją normalności
я этого не отрицаю|nie zaprzeczam temu
гораздо хуже|dużo gorzej
выступил намного лучше|wypadł znacznie lepiej
все меньше людей|coraz mniej osób
это просто невезение|a to dopiero pech
telling a lie, refuting a lie|powiedzenie kłamstwa, obalenie kłamstwa
конечная цель это не победа|ostatecznym celem nie jest zwycięstwo
они были правы|mieli rację
соединяется с другим словом|łączy się z innym wyrazem
я читал довольно много|czytałem całkiem sporo
навсегда|na zawsze
я полагаю|wydaję mi się
ты можешь сделать такое же приложение|możesz stworzyć taką samą aplikację
самые богатые люди, с которыми я когда-либо имел дело|najbogatsi ludzie, z którymi miałem do czynienia
я пытаюсь что-то сделать|próbuję coś zrobić
они не понимают, что кому-то это может быть неинтересно|nie ogarną, że kogoś może nie interesować
и я начал задаваться вопросом|i zacząłem się zastanawiać
огромный шаг вперёд|ogromny krok naprzód
корректировка договорной мощности|dostosowanie mocy umownej
нам следует быть умными|powinniśmy być mądrzy
это вызовет большие волны миграции|spowoduje to duże fale migracji
его невозможно оскорбить|nie da się go urazić
чтобы доказать, что безопасность больше не существует|aby udowodnić, że bezpieczeństwo już nie istnieje
рано или поздно ты это поймешь|prędzej czy później to zrozumiesz
люди делают себе вред|ludzie robią sobie krzywdę
максимальная грузоподъемность|maksymalna ładowność
однажды ты победишь|pewnego dnia wygrasz
он все-таки умеет драться|jednak potrafi się bić
это сделает мою речь более натуральной|dzięki temu moja mowa będzie bardziej naturalna
это замкнутый круг|działa błędne koło
великолепно с ним справились|pięknie go załatwili
у меня такое чувство|mam przeczucie
я приспособлюсь|ja się dostosuję
не так много интересных материалов|nie ma zbyt wiele interesujących materiałów
выступил намного хуже|wypadł znacznie gorzej
в отличии от нас|w przeciwieństwie do nas
брак по расчету|malozenstwo z rozsądku
спорили часами на пролет|kłóciliśmy się godzinami
любое выражение типа|dowolne wyrażenie typu
идеально подошел для этой роли|idealnie się do tego nadawał
это довольно сложный вопрос|to dość złożona kwestia
он моложе тебя|on jest młodszy od ciebie
всего к оплате|do zapłaty łącznie
и без последствий|i bez konsekwencji
заявляют о своей готовности вступить в армию|deklaruje chęć wstąpienia do armii
вопреки видимости|wbrew pozorom
ты ещё увидишь|zobaczysz później
это не совпадение|nie jest to przypadek
мне хватило одного недостающего элемента|mnie wystarczył jeden brakujący element
почему это происходит со мной?|dlaczego to się ze mną dzieje?
иностранное насилие|przemoc obca
огромный шаг назад|ogromny krok wstecz
откуда я тебя знаю?|skąd cię znam?
он никуда не исчез|nie zniknął nigdzie
неоднозначные ответы|niejednoznaczne odpowiedzi
трудно остановиться|trudno jest się zatrzymać
его не может победить никакая сила|nie da się pokonać żadną mocą
и в один день|i któregoś dnia
я придерживаюсь мнения|jestem zdania
сам об этом понятия не имею|sam nie mam o tym pojęcia
намного лучше|dużo lepiej
как ты решишь эту проблему?|jak rozwiążesz ten problem?
чтобы оказалось, что это хорошо|żeby okazało się, że jest dobrze
куда ты идешь|dokąd idziesz
откуда ты идешь|skąd idziesz
но его действия гораздо хуже|ale jego czyny są o wiele gorsze
ни один эксперт не в состоянии|żaden ekspert nie jest w stanie
estimated reading|odczyt szacowany
никому ни при каких обстоятельствах об этом не рассказывать|żebym pod żadnym pozorem nie mówił nikomu
мы могли бы говорить часами|potrafiliśmy gadać godzinami
преимущества и недостатки|zalety i wady
меня озадачивает|mnie zastanawia
у меня есть привычка|mam zwyczaj
рядом с кроватью сидела мама|koło łóżka siedziała mama
что с ним случилось|co się z nim stało
выступил намного лучше|wypadł znacznie lepiej
он хотел, чтобы оказалось, что он врет|chciał żeby wyszło, że on kłamie
замена существующих источников света|wymianę istniejących źródeł światła
поэтому я скажу это за всех вас|więc powiem to za was wszystkich
я начал учить польский|zacząłem uczyć się polskiego
как я мог иметь такой подход ко многим темам|jak w ogóle mogłem mieć takie podejście do wielu tematów
все менее дружелюбный|coraz mniej przyjazny
в любом случае, размер не имеет значения|zresztą rozmiar się nie liczy
война почти незбежна|wojna jest prawie nieunikniona
такие люди выдают столько тезисов|tacy ludzie rzucają tyloma tezami
он сделает еще лучше|poradzi sobie jeszcze lepiej
и вообще этого следует избегать|i na ogół powinno się tego unikać
использует против него язык ненависти|stosuje wobec niego mowę nienawiści
в моем ближайшем окружении|w moim najbliższym środowisku
я не выдавал себя за полицию|nie podawałem się za policję
каждый раз, когда ты что-то делаешь|za każdym razem, gdy coś robisz
меня удивляет, как он получил подписи|zastanawia mnie jak zdobył podpisy
мне все равно|nie obchodzi mnie
и почти все нормально|i prawie wszystko jest normalne
откуда это начинается - куда это идет|skąd wyrusza – dokąd zmierza
нанести непоправимый вред|spowodować nieodwracalną szkodę
без колебаний|bez zająknięcia
они такие же самые|są tacy sami
выращивать овощи|uprawiać warzywa
обоснованность конкретных действий|słuszności określonych działań
необходимое оборудование|niezbędny sprzęt/niezbędne wyposażenie
помогаю достичь намеченной цели|pomagam osiągnąć zamierzony cel
он скажет все что надо|powie wszystko, co trzeba
я бы сказал по другому|powiedziałbym to inaczej
скопировать текст|skopiować tekst
выделить текст|zaznaczyć tekst
работа с людьми — моя стихия|praca z ludźmi to mój żywioł
проверка|sprawdzanie
деятельность|czynności
соблюдение|przestrzeganie
необходимая информация|niezbędne informacje
они пришли к такому выводу|doszli do takiego wniosku
еще один тяжелый день подряд|kolejny ciężki dzień z rzędu
наплыв мыслей|natłok myśli
наплыв стресса в последние несколько дней|natłok stresu w przeciągu ostatnich dni
мои навыки|moje umiejętności
раскрыли проект бюджета|ujawnili projekt budżetu
текущий бюджет|obecny budżet
когда появится следующая возможность|kiedy trafi się kolejna okazja
не дал бы решить о покупке косилки|nie dałbym zadecydować o zakupie kosiarki
экономика идет в никуда|gospodarka zmierza donikąd
основание языковой школы|założenie szkoły językowej
создание языковой школы|utworzenie szkoły językowej
какое мне дело до того, что волнует тебя|co mnie obchodzi co ciebie obchodzi
почему меня это должно волновать?|dlaczego powinno mnie obchodzić?
честно говоря, мне все равно|mówiąc szczerze mało mnie obchodzi
это меня сильно пугает|to mnie bardzo przeraża
толстый|gruby
тонкий|cienki
разрушение|zagłada
однажды, от скуки, я немного углубился в эту тему|kiedyś z nudów zanurkowałem trochę w ten temat
это очень печально|to bardzo przykre
чувствуют себя совершенно безнаказанными|czuja się całkowicie bezkarne
с восторгом смотрят в зеркало|patrzą w lustro w zachwyceniu
сценарий, которого я лично очень опасаюсь|scenariusz którego się bardzo osobiście obawiam
отвратительная ложь|obleśne kłamstwa
делание глупых людей знаменитыми|robienie głupich ludzi sławnymi
очень точно|bardzo trafne
прошлый год был холоднее|ostatni rok był zimniejszy
прошлой зимой у нас не было снега|zeszłej zimy nie mieliśmy śniegu
что их вчера расстроило|co ich wpieniło wczoraj
им все равно|nie przejmują się
стандартное оборудование|standardowe wyposażenie
лицензия на вождение велосипеда|uprawnienia do jazdy rowerem
вопреки видимости|wbrew pozorom
не ставит перед собой целей|nie narzuca sobie celów
разница в том|różnica polega na tym
вырвано из контекста|wyjęte z kontekstu
прогрессирует поляризация общества|postępuje polaryzacja społeczeństwa
идет в плохом направлении|idzie to w złą stronę
я сторонник приобретения знаний|ja akurat jestem zwolennikiem pozyskiwania wiedzy
как оцениваешь этого политика|jak oceniasz tego polityka
прошлый год был вторым подряд, когда|miniony rok był już drugim z rzędu, gdy
на улицы выйдут как противники, так и сторонники|na ulice wyjadą przeciwnicy oraz zwolennicy
из-за страха конфронтации|w obawie przed konfrontacją
выразь несогласие с некомпетентностью властей|wyraź sprzeciw wobec nieudolności władzy
услышали обвинения|usłyszeli zarzuty
пусть скажет то же самое|niech powie to samo
скоро|wkrótce
на работе подвергаются словесным нападкам|są atakowani słownie w pracy
неудачная авария водителя|pechowa kraksa kierowcy
собираюсь потратить|zamierzam wydać
поэтому собираюсь дать ей шанс|więc zamierzam dać jej szansę
чтобы быть уверенным|aby mieć pewność
вам понадобится правильный инструмент|będziesz potrzebować odpowiedniego narzędzia
испытывает колоссальное трение|doświadcza ogromnego tarcia
постоянно подвергается трению|wielokrotnie podlega tarciu
также является ключевым фактором|jest również kluczowym czynnikiem
обычно|zazwyczaj
что именно мы обычно делаем неправильно|co konkretnie zazwyczaj robimy źle
я предпочитаю качественную информацию|wolę wysokiej jakości informację
но одинаково эффективный|lecz równie skuteczny
презрительный термин|pogardliwy termin
если факты не соответствуют мнениям, тем хуже для фактов|jeśli fakty nie pasują do opinii, to tym gorzej dla faktów
не предоставляет полезной информации|nie dostarcza użytecznych informacji
способствует глобальному потеплению|napędza globalne ocieplenie
происходят быстрые изменения климата|zachodzą gwałtowne zmiany klimatu
ассоциация слов с погромами может показаться преувеличенной|skojarzenie słów z pogromami może wydawać się przesadzone
власти не противодействуют угрозе и скрывают информацию|władza nie przeciwdziała zagrożeniu, ukrywa informacje
бессмертная сцена|nieśmiertelna scena
не имею возражений|nie mam zastrzeżeń
обрати особое внимание|zwróć szczególną uwagę
хотим продолжать ездить|chcemy jeździć nadal
а где главный пожарный?|gdzie jest naczelny strażak?
главный проект|naczelny projekt
это одна из моих основных ценностей|to jedna z moich naczelnych wartości
либо неуклюжая правда, либо идеальная ложь|albo niezdarna prawda, albo doskonałe kłamstwo
случайная работа|praca dorywcza
воспринимаются серьезно|brane są na poważnie
я выражаю свои соболезнования|przesyłam wyrazy współczucia
доверчивость|łatwowierność
может изменить чье-то мнение|może zmienić czyjeś zdanie
показывать факты|pokażywać fakty
болеешь странной болезнью|chorujesz na te dziwne schorzenie
имеет небольшое влияние|ma znikomy wpływ
коренные граждане|rodzimy obywatele
слабая связь|nikły związek
слабый|nikły
не каждый день|nie codziennie
я такой понимающий|jestem taki wyrozumiały
нам не повезло|mamy pecha
гонка со временем|wyścig z czasem
преступление против собственности|przestępstwo przeciwko mieniu
заменить|zastępować
вы бы приняли участие в таком конкурсе?|bralibyście udział w takim konkursie?
мы были там уже два раза и хотели бы поехать в третий раз|byliśmy tam już dwa razy i z chęcią wybralibyśmy się trzeci
один говорит другому|jeden mówi do drugiego
